111111111111111
1000000P0000001
100000000000001
101111111111111
101CCCCC1000101
1000010C00100E1
111111111111111