111111111111111
100000000000001
100P00000000001
100000000000001
100000000000001
100CCC000000001
111111111111111