111111111111111
100000000000001
100E00000000001
100000000000001
100000000000001
100CCC00000P001
111111111110111