111111111111111
101110000000001
101E10000000001
101110000000001
100000000000001
100CCC00000P001
111111111111111